00000000000000000000000000000000000000000000000000000aaaaaa0000000000000000000000000000000000000000000000000211111110000000000000000000000000000000000000000000000bbbbbb0000000000000000000000000000000000000000000000000000009
00000000000000000000000000000000000000000000000000000aaaaaa0000000000000000000000000000000000000000000000000311111110000000000000000000000000000000000000000000000bbbbbb0000000000000000000000000000000000000000000000000000009
00000000000000000000000000000000000000000000000000000aaaaaa0000000000000000000000000000000000000000000000000311111110000000000000000000000000000000000000000000000bbbbbb0000000000000000000000000000000000000000000000000000009
00000000000000000000000000000000000000000000000000000aaaaaa0000000000000000000000000000000000000000000000000000000000000000000000000000000000000000000000000000000bbbbbb0000000000000000000000000000000000000000000000000000009
0000000000000000000000000000000000000000000000002111111111111111110000000000000000000000000000000000000000000000000000000000000000000000000000000000000000000021111111111111111100000000000000000000000000000000000000000000009
0000000000000000000000000000000000000000000000003111111111111111110000000000000000000000000000000000000000000000000000000000000000000000000000000000000000000031111111111111111100000000000000000000000000000000000000000000009
0000000000000000000000000000000000000000000000000000000000000000000000000000000000000000000000000000000000000000000000000000000000000000000000000000000000000000000000000000000000000000000000000000000000000000000000000000009
0000000000000000000000000000000000000000000000000000000000000000000000000000000000000000000000000000000000000000000000000000000000000000000000000000000000000000000000000000000000000000000000000000000000000000000000000000009
0000000000000000000000000000000000000000000000000000000000000000000000000000000002111111111111111000000000000000000000000000000211111111111111100000000000000000000000000000000000000000000000000000000000000000000000000000009
0000000000000000000000000000000000000000000000000000000000000000000000000000000003111111111111111000000000000000000000000000000311111111111111100000000000000000000000000000000000000000000000000000000000000000000000000000009
0000000000000000000000000000000000000000000000000000000000000000000000000000000002111100000000000000000000000000000000000000000000000000002111100000000000000000000000000000000000000000000000000000000000000000000000000000009
0000000000000000000000000000000000000000000000000000000000000000000000000000000003111100000000000000000000000000000000000000000000000000003111100000000000000000000000000000000000000000000000000000000000000000000000000000009
0000000000000000000000000211111112111000000000000000000000000000000000000000000000000000000000000000000000000000000000000000000000000000000000000000000000000000000000000000000000000000021112111111100000000000000000000000009
0000000000000000000000000311111113111000000000000000000000000000000000000000000000000000000000000000000000000000000000000000000000000000000000000000000000000000000000000000000000000000031113111111100000000000000000000000009
0000000000000000000000000000000003111000000000000000000000000000000000000000000000000000000000000000000000000000000000000000000000000000000000000000000000000000000000000000000000000000031110000000000000000000000000000000009
0000000000000000000000000000000003111000000000000000000000000000000000000000000000000000000000000000000000000000000000000000000000000000000000000000000000000000000000000000000000000000031110000000000000000000000000000000009
0000000000000000000000000000000003111000000000000000000000000000000000000000000000000000000000000000000000000000000000000000000000000000000000000000000000000000000000000000000000000000031110000000000000000000000000000000009
0000000000000000000000000000000003111000000000000000000000000000000000000000000000000000000000000000000000000000000000000000000000000000000000000000000000000000000000000000000000000000031110000000000000000000000000000000009
0000000000000000000000000000000003111000000000000000000000000000000021111111000000000000000000000000000000000000000000000000000000000000000000000000211111110000000000000000000000000000031110000000000000000000000000000000009
0000000000000000000000000000000003111000000000000000000000000000000031111111000000000000000000000000000000000000000000000000000000000000000000000000311111110000000000000000000000000000031110000000000000000000000000000000009
0000000000000000000000000000000003111000000000000000000000000000000031111111000000000000000000000000000000000000000000000000000000000000000000000000311111110000000000000000000000000000031110000000000000000000000000000000009
0000000000000000000000000000000003111000000000000000000000000000000031111111000000000000000000000000000000000000000000000000000000000000000000000000311111110000000000000000000000000000031110000000000000000000000000000000009
0000000000000000000000000000000003111000000000000000000000000000000000000000000000000000000000000000000000000000000000000000000000000000000000000000000000000000000000000000000000000000031110000000000000000000000000000000009
0000000000000000000000000000000003111000000000000000000000000000000000000000000000000000000000000000000000000000000000000000000000000000000000000000000000000000000000000000000000000000031110000000000000000000000000000000009
0000000000000000000000000000000003111000000000000000000000000000000000000000000000000000000000000000000000000000000000000000000000000000000000000000000000000000000000000000000000000000031110000000000000000000000000000000009
0000000000000000000000000000000003111000000000000000000000000000000000000000000000000000000000000000000000000000000000000000000000000000000000000000000000000000000000000000000000000000031110000000000000000000000000000000009
0000000000000000000000000211111113111000000000000000000000000000000000000000000000000000000000000000000000000000000000000000000000000000000000000000000000000000000000000000000000000000031112111111100000000000000000000000009
0000000000000000000000000311111113111000000000000000000000000000000000000000000000000000000000000000000000000000000000000000000000000000000000000000000000000000000000000000000000000000031113111111100000000000000000000000009
0000000000000000000000000000000000000000000000000000000000000000000000000000000002111100000000000000000000000000000000000000000000000000002111100000000000000000000000000000000000000000000000000000000000000000000000000000009
0000000000000000000000000000000000000000000000000000000000000000000000000000000003111100000000000000000000000000000000000000000000000000003111100000000000000000000000000000000000000000000000000000000000000000000000000000009
0000000000000000000000000000000000000000000000000000000000000000000000000000000002111111111111111000000000000000000000000000000211111111111111100000000000000000000000000000000000000000000000000000000000000000000000000000009
0000000000000000000000000000000000000000000000000000000000000000000000000000000003111111111111111000000000000000000000000000000311111111111111100000000000000000000000000000000000000000000000000000000000000000000000000000009
0000000000000000000000000000000000000000000000000000000000000000000000000000000000000000000000000000000000000000000000000000000000000000000000000000000000000000000000000000000000000000000000000000000000000000000000000000009
0000000000000000000000000000000000000000000000000211111111111111110000000000000000000000000000000000000000000000000000000000000000000000000000000000000000000021111111111111111100000000000000000000000000000000000000000000009
0000000000000000000000000000000000000000000000000311111111111111110000000000000000000000000000000000000000000000000000000000000000000000000000000000000000000031111111111111111100000000000000000000000000000000000000000000009
0000000000000000000000000000000000000000000000000000000000000000000000000000000000000000000000000000000000000000000000000000000000000000000000000000000000000000000000000000000000000000000000000000000000000000000000000000009
000000000000000000000000000000000000000000000000000cccccc00000000000000000000000000000000000000000000000000000000000000000000000000000000000000000000000000000000000dddddd00000000000000000000000000000000000000000000000000009
000000000000000000000000000000000000000000000000000cccccc00000000000000000000000000000000000000000000000000021111111000000000000000000000000000000000000000000000000dddddd00000000000000000000000000000000000000000000000000009
000000000000000000000000000000000000000000000000000cccccc00000000000000000000000000000000000000000000000000031111111000000000000000000000000000000000000000000000000dddddd00000000000000000000000000000000000000000000000000009
000000000000000000000000000000000000000000000000000cccccc00000000000000000000000000000000000000000000000000031111111000000000000000000000000000000000000000000000000dddddd00000000000000000000000000000000000000000000000000009
9999999999999999999999999999999999999999999999999999999999999999999999999999999999999999999999999999999999999999999999999999999999999999999999999999999999999999999999999999999999999999999999999999999999999999999999999999999